#######################
#  > ####   ##       # @ 
#    ##     ####### ###
## #### #   ###      ##
 # #### #######  ### ##
 # ####           ## ##
 #      ######       ##
#######################