!!!!!!!!!!!!!!!!!!!!!!!!!
!#######################! 
!#  > ####   ##@       #!
!#    ##     ####### ###!
!####### #   ###      ##!
! # #### #######  ### ##!
! # ####           ## ##!
! #      ######       ##!
!#######################!
!!!!!!!!!!!!!!!!!!!!!!!!!