#######################
#  > ####   ##@       #
#    ##     ####### ###
## #### #   ###      ##
 # #### #######  ### ##
 # ####          ### ##
 #      ######       ##
#######################