#######################
#  > ####   ##@       #
#    ##     ####### ###
####### #   ###      ##
 # #### #######  ### ##
 # ####           ## ##
 #      ######       ##
#######################