#######################  
#  > ####   ##@       #
#    ##     ####### ###
####### #   ###      ##
 # #### #######  ### ######
 # ####           ## ##
 #      ######       ##
#######################