#######################
#  > ####   ##       #@
#    ##     ####### ###
## #### #   ###      ##
 # #### #######  ### ##
 # ####           ## ##
 #      ######       ##
#######################